[
    {
        "title": "\"We need to cook\"",
        "body": [
            "0000000000000000",
            "0000000000000000",
            "0111111111111110",
            "0000000000000000",
            "0000000000000000",
            "0111111111111110",
            "0000000000000000",
            "0000000000000000",
            "0111111111111110"
        ]
    },
    {
        "title": "W.W.",
        "body": [
            "0000000000000000",
            "0000000000000000",
            "0010101001010100",
            "0010101001010100",
            "0010101001010100",
            "0010101001010100",
            "0001010000101000",
            "0000000000000000",
            "0000000000000000"
        ]
    },
    {
        "title": "It's supposed to be an RV",
        "body": [
            "0000000000000000",
            "0000000000000000",
            "0111111111111110",
            "0111111111100110",
            "0111111111111110",
            "0001100000011000",
            "0000000000000000",
            "0000000000000000",
            "0000000000000000"
        ]
    },
    {
        "title": "737",
        "body": [
            "0000000000000000",
            "0000000000000000",
            "0111100110011110",
            "0000101001000010",
            "0001000010000100",
            "0010001001001000",
            "0010000110001000"
        ]
    },
    {
        "title": "Walter White?",
        "body": [
            "0000000000000000",
            "0000011111100000",
            "0000011111100000",
            "0000111111110000",
            "0000000000000000",
            "0000111001110000",
            "0001111111111000",
            "0000111001110000",
            "0000000000000000",
            "0000000110000000",
            "0000001001000000",
            "0000001111000000",
            "0000001111000000"
        ]
    }
]