[
    [
    "0000000000000000",
    "0000000000000000",
    "0000000000000000",
    "0000000000000000",
    "0000000000000000",
    "0000000000000000",
    "0000000000000000",
    "0000000000000000"
    ],
    [
    "0000000000000000",
    "0000000000000000",
    "0111111111111110",
    "0000000000000000",
    "0000000000000000",
    "0111111111111110",
    "0000000000000000",
    "0000000000000000",
    "0111111111111110"
    ],
    [
    "0000000000000000",
    "0111111111111110",
    "0111111111100110",
    "0111111111111110",
    "0001100000011000",
    "0000000000000000",
    "0000000000000000",
    "0000000000000000"
    ],
    [
    "0000000000000000",
    "0000000000000000",
    "0010101001010100",
    "0010101001010100",
    "0010101001010100",
    "0010101001010100",
    "0001010000101000",
    "0000000000000000",
    "0000000000000000"
    ]

]